11111111111111111111111111111111111111111111111111111111
11C00000000C0000000C00000000C0000000000E0000000000000001
110000X0000000000000000000000000000000000000000000000001
1000000000PC00000000000C0000000C000000000000000000000001
100000000C0000000000000000000C000000000000C0000000000001
111100000X00000000C000000000000000000000000000000X000001
100000000C0000000000000000000C000000000000C0000000000001
100000000000000000000000000000000000000C0000000000000C01
11111111111111111111111111111111111111111111111111111111