1111111111111111111111111111
11C00000001C0000000000000011
1100000000111111111101111011
1000000001PCX0000001011C1011
100000001C10E000000101101011
1111X0001000000000C100001011
100000000C100000000111111011
1000000011100000XX0000000011
1000000000000000000000000001
11C00000001C0000000000000011
1100000000111111111101111011
10000000001CX0000001011C1011
100000001C10000000101101011
1111X0001000000000C100001011
1111111111111111111111111111