111111111111111111111111111111
1111CCCCCCCCCCCCCCCCCCCCCCCCC1
11111EP00000000000000000000001
111111111111111111111111111111