11111111111111111
1000000000000ECP1
11111000000000001
11111111111111111