11111111111111111111111111111111111111111111111111111111
11C00000000C0000000C00000000C0000000000E0000000000000001
11000000000000000000000000000000000000000000000000000001
1000000000PC00000000000C0000000C000000000000000000000001
100000000C0000000000000000000C000000000000C0000000000001
111100000000000000C0000000000000000000000000000000000001
100000000C0000000000000000000C000000000000C0000000000001
100000000000000000000000000000000000000C0000000000000C01
11111111111111111111111111111111111111111111111111111111