11111111111111111111111111111111111111111111111111111111
11C00000000C0000000C00000000C0000000000E0000000000000001
11000000000000000000000000000000000000000000000000000001
1000000000PC00000000000C0000000C000000000000000000000001
100000000C0000000000000000000C000000000000C00000X0000001
1111X0000000000000C000000000000000000000000000X000000001
100000000C0000000000000000000C000000000000C00000X0000001
1000000000000000X0000000000X00000000000C0000000000000C01
11111111111111111111111111111111111111111111111111111111
