1111111111
10P0EC0101
1000000001
1111111111