1111111111
10000E0001
1P00000001
1000001111
1111111111